############
#      #   #
# ##  ##D# #
# #  #G  # #
#     ###  #
# #### #   #
# #    #   #
# # # ##   #
#   #     K#
############